445 445 445 445 445 445 445 445 445 445 445 445 445 445 445 445 445 445 445 445 445 445 445 445 445 445 445 445 445 445 445 445 
445 445 445 445 445 445 445 445 445 445 445 445 445 445 445 445 445 445 445 445 445 445 445 445 445 445 445 445 445 445 445 445 
445 445 0 0 0 0 0 0 0 0 0 0 0 0 0 0 0 0 0 0 0 0 0 0 0 0 0 0 0 0 445 445 
445 445 0 0 0 0 0 0 0 445 0 0 0 0 0 0 0 0 0 0 0 0 0 0 0 0 0 0 0 0 445 445 
445 445 0 0 0 0 0 0 0 445 0 0 0 0 0 0 0 0 0 0 0 0 0 0 0 0 0 0 0 0 445 445 
445 445 0 0 0 0 0 0 0 445 0 0 0 0 0 0 0 445 445 0 0 0 0 0 0 0 0 0 0 0 445 445 
445 445 0 0 0 0 0 0 0 0 0 0 0 0 0 0 0 445 445 0 0 0 0 0 0 0 0 0 0 0 445 445 
445 445 0 0 0 0 0 0 0 0 0 0 0 0 0 0 0 0 0 0 0 0 0 0 0 0 0 0 0 0 445 445 
445 445 445 445 445 445 0 0 0 0 0 0 0 0 0 0 0 0 0 0 0 0 0 0 0 0 445 445 445 445 445 445 
445 445 445 445 445 445 0 0 0 0 0 0 0 0 0 0 0 0 0 0 0 0 0 0 0 0 445 445 445 445 445 445 
445 445 0 0 0 0 0 0 0 0 0 0 0 0 0 0 0 0 0 0 0 0 0 0 0 0 0 0 0 0 445 445 
445 445 0 0 0 0 0 0 0 0 0 0 0 0 0 0 0 0 0 0 0 0 0 0 0 0 0 0 0 0 445 445 
445 445 0 0 0 0 0 0 0 0 0 0 0 0 0 0 0 0 0 0 445 445 445 0 0 0 0 0 0 0 445 445 
445 445 0 0 0 0 0 0 445 445 445 445 0 0 0 0 0 0 0 0 445 445 445 0 0 0 0 0 0 0 445 445 
445 445 0 0 0 0 0 0 0 0 0 0 0 0 0 0 0 0 0 0 0 0 0 0 0 0 0 0 0 0 445 445 
445 445 0 0 0 0 0 0 0 0 0 0 0 0 0 0 0 0 0 0 0 0 0 0 0 0 0 0 0 0 445 445 
445 445 445 445 445 445 445 445 445 445 445 445 445 445 445 445 445 445 445 445 445 445 445 445 445 445 445 445 445 445 445 445 
445 445 445 445 445 445 445 445 445 445 445 445 445 445 445 445 445 445 445 445 445 445 445 445 445 445 445 445 445 445 445 445 

