109 76 76 76 76 76 76 76 76 76 76 76 76 76 76 76 76 76 76 76 76 76 76 76 76 76 76 76 76 76 76 110 
294 514 514 0 0 0 0 0 0 0 0 0 0 0 0 0 0 0 0 0 0 0 0 0 0 514 0 0 0 0 0 296 
294 514 514 0 0 0 0 0 0 0 0 0 0 0 0 0 0 0 0 0 0 0 0 0 0 514 0 0 0 0 0 296 
294 0 0 0 0 0 0 0 0 0 0 0 0 0 0 0 0 0 0 0 0 0 0 0 0 0 0 0 0 0 0 296 
294 0 0 0 0 0 0 447 447 447 0 0 0 0 0 0 49 158 158 158 158 48 0 0 0 0 0 0 0 0 0 296 
294 0 0 0 0 0 447 0 0 0 0 0 0 0 0 0 0 181 182 181 182 0 0 0 0 0 0 0 0 0 0 296 
294 0 0 0 0 0 447 0 0 0 0 0 0 0 0 0 0 217 218 217 218 0 0 0 0 0 0 0 0 0 0 296 
294 0 0 0 0 0 447 0 0 0 0 0 0 0 0 0 0 0 181 182 0 0 0 0 0 0 0 0 0 0 0 296 
294 0 0 0 0 0 0 517 517 0 0 0 0 0 0 0 0 194 217 218 193 0 0 0 0 0 0 0 0 0 0 296 
294 0 0 0 0 0 0 0 0 447 0 0 0 0 0 0 0 85 156 156 84 0 0 0 0 447 447 0 0 0 0 296 
294 0 0 0 0 0 0 0 0 447 0 0 0 0 0 0 0 0 0 0 0 0 0 0 447 0 0 0 0 0 0 296 
294 0 0 0 0 0 0 0 0 447 0 0 0 0 0 0 0 0 0 0 0 0 0 0 0 447 0 0 0 0 0 296 
294 0 0 0 0 0 447 447 447 0 0 0 0 0 0 0 0 0 0 0 0 0 0 0 0 0 447 0 0 0 0 296 
294 0 0 0 0 0 0 0 0 0 0 0 0 0 514 514 514 0 0 0 0 0 0 0 0 0 0 447 0 0 0 296 
294 0 0 0 0 0 0 0 0 0 0 0 0 0 0 0 0 0 0 0 0 0 0 0 0 447 447 0 0 0 0 296 
294 0 0 0 0 0 0 0 0 0 0 0 0 0 0 0 0 0 0 0 0 0 0 0 0 0 0 0 0 0 0 296 
294 514 514 514 0 0 0 0 0 0 0 0 0 0 0 0 0 0 0 0 0 0 0 0 0 0 0 0 0 0 0 296 
330 331 331 331 331 331 331 331 331 331 331 331 331 331 331 331 331 331 331 331 331 331 331 331 331 331 331 331 331 331 331 332 
