82 82 82 445 445 445 445 445 445 445 445 445 445 445 445 445 445 445 445 445 445 445 445 445 445 445 445 445 445 445 82 82 
82 82 82 0 0 0 0 0 0 0 0 0 0 0 0 0 0 0 0 0 0 10 10 10 0 0 0 0 0 0 82 82 
82 0 0 0 0 0 0 0 0 0 0 0 0 0 0 0 0 0 0 0 0 10 517 10 0 0 0 0 0 0 0 445 
445 0 0 0 0 0 0 0 0 0 0 0 0 0 0 0 0 0 0 0 0 10 10 10 0 0 0 0 0 0 0 445 
445 0 0 0 0 0 0 0 0 0 0 0 0 0 0 0 0 0 0 0 0 0 0 0 0 0 0 0 0 0 0 445 
445 0 0 0 0 0 0 0 0 0 0 10 0 0 0 0 0 0 0 0 0 0 0 0 0 0 0 0 0 0 0 445 
445 0 0 0 0 0 0 0 10 10 10 10 0 0 0 0 0 0 0 0 0 0 0 0 0 0 0 0 0 0 0 445 
445 0 0 0 0 0 0 0 10 10 10 0 0 0 0 0 0 0 0 0 0 0 0 0 0 0 0 0 0 0 0 445 
445 0 0 0 0 0 0 0 0 10 10 0 0 0 0 0 0 0 0 0 0 0 0 0 0 0 0 0 0 0 0 445 
445 0 0 0 0 0 0 0 0 10 0 0 0 0 0 0 0 0 0 0 0 0 0 0 0 10 10 0 0 0 0 445 
445 0 0 0 0 0 0 0 0 0 0 0 0 0 0 0 0 0 0 0 0 0 0 0 0 10 0 0 0 0 0 445 
445 0 0 0 0 0 0 0 0 0 0 0 0 0 0 0 0 0 0 0 0 0 0 0 10 10 0 0 0 0 0 445 
445 0 0 0 0 0 0 0 0 0 0 0 0 0 0 82 82 0 0 0 0 0 0 10 10 10 0 0 0 0 0 445 
445 0 0 0 0 0 0 0 0 0 0 0 0 0 82 82 0 0 0 0 0 0 0 0 0 0 0 0 0 0 0 445 
445 0 0 0 0 0 0 0 0 0 0 0 0 82 82 0 0 0 0 0 0 0 0 0 0 0 0 0 0 0 0 445 
445 0 0 0 0 0 0 0 0 0 0 0 82 82 0 0 0 0 0 0 0 0 0 0 0 0 0 0 0 0 0 445 
445 0 0 0 0 0 0 0 0 0 0 0 82 82 0 0 0 0 0 0 0 0 0 0 0 0 0 0 0 82 82 445 
445 445 445 445 445 445 445 445 445 445 445 445 445 445 445 445 445 445 445 445 445 445 445 445 445 445 445 445 445 445 445 445 
