397 362 362 362 362 362 362 362 362 362 362 362 362 362 362 362 362 362 362 362 362 362 362 362 362 362 362 362 362 362 362 398 
401 0 0 0 0 0 0 0 0 0 0 0 0 0 0 0 0 0 0 445 0 0 0 0 0 0 0 0 0 0 0 401 
401 0 0 0 0 0 0 0 0 0 0 0 0 0 0 0 0 0 0 445 0 0 0 0 0 0 0 0 0 0 0 401 
401 0 0 0 0 0 0 0 0 0 0 0 0 0 0 0 0 0 0 445 0 0 0 0 0 0 0 0 0 0 0 401 
401 0 0 0 0 445 445 445 0 0 0 0 0 0 0 0 0 0 0 445 0 0 0 0 30 31 32 0 0 0 0 401 
401 0 0 0 0 0 0 0 0 0 0 0 0 0 0 0 0 0 0 0 0 0 0 0 66 67 68 0 0 0 0 401 
401 0 0 0 0 0 0 0 0 0 0 0 0 0 0 0 0 0 0 0 0 0 0 0 102 103 104 0 0 0 0 401 
401 0 0 0 0 0 0 0 0 0 0 0 0 208 209 0 0 0 0 0 0 0 0 0 0 0 0 0 0 0 0 401 
437 0 0 0 0 0 0 0 0 0 0 0 0 244 245 0 0 0 0 0 0 0 0 0 0 0 0 0 0 0 0 401 
0 283 283 283 283 283 0 0 0 0 0 0 0 0 0 208 209 0 0 0 0 0 0 0 0 0 0 0 0 0 0 401 
0 319 319 280 281 319 0 0 0 0 0 0 0 0 0 244 245 0 0 0 0 0 0 0 0 0 0 0 445 445 0 401 
0 319 319 316 317 319 0 0 0 0 0 0 0 0 0 0 0 0 0 0 0 0 0 0 0 0 445 445 445 445 445 401 
0 319 319 319 353 0 0 0 0 0 0 0 0 0 0 0 0 0 0 0 0 0 0 0 0 445 0 0 0 0 0 401 
0 319 319 319 319 0 0 0 0 0 0 0 0 0 0 0 0 0 0 0 0 0 0 0 445 0 0 0 0 0 0 401 
319 280 281 319 319 0 0 0 0 0 0 0 0 0 0 0 0 0 0 0 0 0 0 0 0 0 0 0 0 0 0 401 
319 316 317 319 319 0 283 283 0 0 0 0 0 0 0 0 0 0 0 0 0 0 0 0 0 0 0 0 0 0 0 401 
319 352 353 319 319 319 319 319 0 0 0 0 0 0 0 0 0 0 0 0 0 0 0 0 0 0 0 0 0 0 0 401 
319 319 319 319 319 319 319 319 361 362 362 362 362 362 362 362 362 362 362 362 362 362 362 362 362 362 362 362 362 362 362 434 
