205 166 166 166 166 166 166 166 166 166 166 166 166 166 166 166 166 166 166 166 166 166 166 166 166 166 166 166 166 166 166 206 
131 447 447 447 0 0 0 0 0 0 0 0 0 0 0 0 0 0 0 0 0 0 0 447 442 447 0 0 0 0 0 129 
131 447 0 0 0 0 0 0 0 0 0 0 0 0 0 0 0 0 0 0 0 0 0 447 447 447 0 0 0 0 0 129 
131 447 0 0 0 0 0 0 0 0 0 0 0 0 0 0 0 0 0 0 0 0 0 0 0 0 0 0 0 0 0 129 
131 0 0 0 0 0 0 0 0 0 0 0 0 0 0 0 0 0 0 0 0 0 0 0 0 0 0 0 0 0 0 129 
131 0 0 0 0 0 0 0 0 0 0 0 0 0 0 0 0 447 447 0 0 0 0 0 0 0 0 0 0 0 0 129 
131 0 0 0 0 0 0 199 200 199 200 0 0 0 0 0 0 447 447 447 447 0 0 0 0 0 0 0 0 0 0 129 
131 0 0 0 0 0 0 235 236 235 236 0 0 0 0 0 0 447 442 447 0 0 0 0 0 0 0 0 0 0 0 129 
131 0 0 0 0 0 0 0 199 200 0 0 0 0 0 0 0 0 447 447 0 0 0 0 0 0 0 0 0 0 0 129 
131 0 0 0 0 0 0 0 235 236 0 0 0 0 0 0 0 0 0 0 0 0 0 0 0 0 0 0 0 0 0 129 
131 0 0 0 0 0 0 0 0 0 0 0 0 0 0 0 0 0 0 0 0 0 0 0 0 0 0 0 0 0 0 129 
131 442 0 0 0 0 0 0 0 0 0 0 0 0 0 0 0 0 0 0 0 0 0 0 0 0 0 0 0 0 0 129 
447 447 447 447 0 0 0 0 0 0 0 0 0 0 0 0 447 0 0 0 0 0 0 447 0 0 0 0 0 0 0 129 
447 447 447 0 0 0 0 0 0 0 0 0 0 0 0 0 0 0 0 0 0 0 0 447 447 0 0 0 0 0 0 129 
131 0 0 0 0 0 0 0 0 0 0 447 0 0 0 0 0 0 0 0 0 0 0 0 447 447 0 0 0 0 0 129 
131 0 0 0 0 0 0 0 0 0 0 0 0 0 0 0 0 0 0 0 0 0 0 0 0 447 447 0 0 0 0 129 
131 0 0 0 0 0 0 0 0 0 0 0 0 0 0 0 0 0 0 0 0 0 0 0 0 442 447 0 0 0 0 129 
343 94 94 94 94 94 94 94 94 94 94 94 94 94 94 94 94 94 94 94 94 94 94 94 94 94 94 94 94 94 94 345 
