447 447 0 0 0 447 447 0 0 0 0 0 0 0 0 447 447 0 0 0 0 0 0 0 0 447 447 0 0 0 447 447 
447 447 0 0 0 447 447 0 0 0 0 0 0 0 0 447 447 0 0 0 0 0 0 0 0 447 447 0 0 0 447 447 
447 447 0 0 0 447 447 0 0 0 0 0 0 0 0 0 0 0 0 0 0 0 0 0 0 447 447 0 0 0 447 447 
447 447 0 0 0 0 0 0 0 0 0 0 0 0 0 0 0 0 0 0 0 0 0 0 0 0 0 0 0 0 447 447 
447 447 0 0 0 0 0 0 0 0 0 0 0 0 0 0 0 0 0 0 0 0 0 0 0 0 0 0 0 0 447 447 
447 447 0 0 0 0 0 0 0 0 0 0 0 0 0 0 0 0 0 0 0 0 0 0 0 0 0 0 0 0 447 447 
447 447 0 0 0 0 0 0 0 0 0 0 0 0 0 0 0 0 0 0 0 0 0 0 0 0 0 0 0 0 447 447 
447 447 0 0 0 447 447 0 0 0 0 0 0 0 0 0 0 0 0 0 0 0 0 0 0 447 447 0 0 0 447 447 
447 447 0 0 0 447 447 0 0 0 0 0 0 0 0 447 447 0 0 0 0 0 0 0 0 447 447 0 0 0 447 447 
447 447 0 0 0 447 447 0 0 0 0 0 0 0 0 447 447 0 0 0 0 0 0 0 0 447 447 0 0 0 447 447 
447 447 0 0 0 447 447 0 0 0 0 0 0 0 0 0 0 0 0 0 0 0 0 0 0 447 447 0 0 0 447 447 
447 447 0 0 0 0 0 0 0 0 0 0 0 0 0 0 0 0 0 0 0 0 0 0 0 0 0 0 0 0 447 447 
447 447 0 0 0 0 0 0 0 0 0 0 0 0 0 0 0 0 0 0 0 0 0 0 0 0 0 0 0 0 447 447 
447 447 0 0 0 0 0 0 0 0 0 0 0 0 0 0 0 0 0 0 0 0 0 0 0 0 0 0 0 0 447 447 
447 447 0 0 0 0 0 0 0 0 0 0 0 0 0 0 0 0 0 0 0 0 0 0 0 0 0 0 0 0 447 447 
447 447 0 0 0 447 447 0 0 0 0 0 0 0 0 0 0 0 0 0 0 0 0 0 0 447 447 0 0 0 447 447 
447 447 0 0 0 447 447 0 0 0 0 0 0 0 0 447 447 0 0 0 0 0 0 0 0 447 447 0 0 0 447 447 
447 447 0 0 0 447 447 0 0 0 0 0 0 0 0 447 447 0 0 0 0 0 0 0 0 447 447 0 0 0 447 447 