514 514 514 514 514 514 514 514 514 514 514 514 514 514 514 514 514 514 514 514 514 514 514 514 514 514 514 514 514 514 514 514 
514 0 0 0 0 0 0 0 0 0 0 0 0 0 0 0 0 0 0 0 0 0 0 0 0 0 0 0 0 0 0 514 
514 514 0 0 0 0 0 0 0 0 0 0 0 0 0 0 0 0 0 0 0 0 0 0 0 0 0 0 0 0 0 514 
514 514 514 0 0 0 0 0 0 0 0 0 0 0 514 514 514 514 514 514 514 514 514 514 514 514 514 0 0 0 0 514 
514 514 514 514 0 0 0 0 0 0 0 0 0 0 514 0 0 0 0 0 0 0 0 0 0 0 514 0 0 0 0 514 
514 514 514 0 0 0 0 0 0 0 0 0 0 0 514 0 0 0 0 0 0 0 0 0 0 0 514 0 0 0 0 514 
514 514 0 0 0 0 0 514 0 0 0 0 0 0 514 0 0 0 0 0 0 0 0 0 0 0 514 0 0 0 0 514 
514 0 0 0 0 0 0 514 0 0 0 0 0 0 514 0 0 0 0 0 0 0 0 0 0 0 514 0 0 0 0 514 
514 0 0 0 0 0 0 514 0 0 0 0 0 0 514 0 0 0 0 0 0 0 0 0 0 0 514 0 0 0 0 514 
514 0 0 0 0 514 514 514 0 0 0 0 0 0 514 514 0 0 0 0 0 0 0 514 514 514 514 0 0 0 0 514 
514 0 0 0 0 514 0 0 0 0 0 0 0 0 0 0 0 0 0 0 0 0 0 0 0 0 0 0 0 0 0 514 
514 0 0 0 0 514 0 0 0 0 0 0 0 0 0 0 0 0 0 0 0 0 0 0 0 0 0 0 0 0 0 514 
514 0 0 0 0 0 0 0 0 0 0 0 0 0 0 0 0 0 0 0 0 0 0 0 0 0 0 0 0 0 0 514 
514 0 0 0 0 0 0 0 0 0 0 0 0 0 0 0 0 0 0 0 0 0 0 0 0 0 0 0 0 0 0 514 
514 0 0 0 0 0 0 0 514 514 0 0 0 0 0 0 0 0 0 514 514 514 514 514 0 0 0 0 0 0 0 514 
514 0 0 0 0 0 0 514 514 514 514 0 0 0 0 0 0 0 0 0 0 0 0 0 0 0 0 0 0 0 0 514 
514 0 0 0 0 0 514 514 514 514 514 514 0 0 0 0 0 0 0 0 0 0 0 0 0 0 0 0 0 0 0 514 
514 514 514 514 514 514 514 514 514 514 514 514 514 514 514 514 514 514 514 514 514 514 514 514 514 514 514 514 514 514 514 514 