517 517 517 517 517 517 517 517 517 517 517 517 517 517 517 517 517 517 517 517 517 517 517 517 517 517 517 517 517 517 517 517 
517 0 0 0 0 0 0 0 0 0 0 0 0 0 0 0 0 0 0 0 0 0 0 0 0 0 0 0 0 0 0 517 
517 0 0 0 0 0 0 0 0 0 0 0 0 0 0 0 0 0 0 0 0 0 0 0 0 0 0 0 0 0 0 517 
517 0 0 0 0 517 0 0 0 0 0 0 0 0 0 0 0 0 0 0 0 0 0 0 0 0 517 0 0 0 0 517 
517 0 0 0 0 517 0 0 0 0 0 0 0 0 0 0 0 0 0 0 0 0 0 0 0 0 517 0 0 0 0 517 
517 0 0 0 0 517 0 0 0 0 0 0 0 0 0 0 0 0 0 0 0 0 0 0 0 0 517 0 0 0 0 517 
517 0 0 517 517 517 0 0 0 0 0 0 0 0 0 0 0 0 0 0 0 0 0 0 0 0 517 517 517 0 0 517 
517 0 0 0 0 0 0 0 0 0 0 517 517 517 517 517 517 517 517 517 517 0 0 0 0 0 0 0 0 0 0 517 
517 0 0 0 0 0 0 0 0 0 0 0 0 0 0 0 0 0 0 0 0 0 0 0 0 0 0 0 0 0 0 517 
517 0 0 0 0 0 0 0 0 0 0 0 0 0 0 0 0 0 0 0 0 0 0 0 0 0 0 0 0 0 0 517 
517 0 0 0 0 517 0 0 0 0 0 0 0 0 0 0 0 0 0 0 0 0 0 0 0 0 517 0 0 0 0 517 
517 0 0 0 0 517 0 0 0 0 0 0 0 0 0 0 0 0 0 0 0 0 0 0 0 0 517 0 0 0 0 517 
517 0 0 0 0 517 517 517 517 517 517 517 0 0 0 0 0 0 0 0 517 517 517 517 517 517 517 0 0 0 0 517 
517 0 0 0 0 0 0 0 0 0 0 517 0 0 0 0 0 0 0 0 517 0 0 0 0 0 0 0 0 0 0 517 
517 0 0 0 0 0 0 0 0 0 0 517 0 0 0 0 0 0 0 0 517 0 0 0 0 0 0 0 0 0 0 517 
517 0 0 0 0 0 0 0 0 0 0 517 0 0 0 0 0 0 0 0 517 0 0 0 0 0 0 0 0 0 0 517 
517 0 0 0 0 0 0 0 0 0 0 517 0 0 0 0 0 0 0 0 517 0 0 0 0 0 0 0 0 0 0 517 
517 517 517 517 517 517 517 517 517 517 517 517 517 517 517 517 517 517 517 517 517 517 517 517 517 517 517 517 517 517 517 517 