445 445 445 445 445 445 445 445 445 445 445 445 445 445 445 445 445 445 445 445 445 445 445 445 445 445 445 445 445 445 445 445 
445 0 0 0 0 0 0 0 0 0 0 0 0 0 0 498 499 0 0 0 0 0 0 0 0 0 0 0 0 0 0 445 
445 0 0 0 0 0 0 0 0 0 0 0 0 0 0 534 535 0 0 0 0 0 0 0 0 0 0 0 0 0 0 445 
445 0 0 0 0 0 0 0 0 426 427 0 0 0 0 0 0 0 0 0 0 0 0 0 0 0 0 0 0 0 0 445 
445 0 0 0 445 445 445 445 0 462 463 0 0 445 445 445 445 445 445 0 0 0 0 0 445 445 445 445 0 0 0 445 
445 0 0 0 0 0 0 445 0 0 0 0 0 445 0 0 0 0 445 0 0 0 0 0 445 0 0 0 0 0 0 445 
445 0 0 0 0 0 0 445 0 0 0 0 0 445 0 0 0 0 445 0 0 496 497 0 445 0 0 0 0 0 0 445 
445 0 426 427 0 0 0 445 0 0 0 0 0 445 0 0 0 0 445 0 0 532 533 0 445 0 0 0 0 0 0 445 
445 0 462 463 0 0 0 445 0 0 496 497 0 445 0 0 0 0 445 0 0 0 0 0 445 0 0 0 0 0 0 445 
445 0 0 0 0 0 0 445 0 0 532 533 0 445 0 0 0 0 445 0 0 0 0 0 445 0 0 0 0 0 0 445 
445 0 0 0 0 0 0 445 0 0 0 0 0 445 0 0 0 0 445 0 0 498 499 0 445 0 0 496 497 0 0 445 
445 0 0 0 0 0 0 445 0 0 0 0 0 445 0 0 0 0 445 0 0 534 535 0 445 0 0 532 533 0 0 445 
445 0 496 497 0 0 0 445 0 0 0 0 0 445 0 0 0 0 445 0 0 0 0 0 445 0 0 0 0 0 0 445 
445 0 532 533 0 0 0 445 445 445 445 445 445 445 0 0 0 0 445 445 445 445 445 445 445 0 0 0 0 0 0 445 
445 0 0 0 0 0 0 0 0 0 0 0 0 0 0 426 427 0 0 0 0 0 0 0 0 0 0 426 427 0 0 445 
445 0 0 498 499 0 0 0 0 0 0 0 0 0 0 462 463 0 0 0 0 0 0 0 0 0 0 462 463 0 0 445 
445 0 0 534 535 0 0 0 0 0 0 0 0 0 0 0 0 0 0 0 0 0 0 0 0 0 0 0 0 0 0 445 
445 445 445 445 445 445 445 445 445 445 445 445 445 445 445 445 445 445 445 445 445 445 445 445 445 445 445 445 445 445 445 445 