514 514 514 514 514 514 514 514 514 514 514 514 514 514 514 514 514 514 514 514 514 514 514 514 514 514 514 514 514 514 514 514 
514 0 0 0 0 0 0 0 0 0 0 0 0 0 0 0 0 0 0 0 0 0 0 0 0 0 0 0 0 0 0 514 
514 0 0 0 0 0 0 0 0 0 0 0 0 0 0 0 0 0 0 0 0 0 0 0 0 0 0 0 0 0 0 514 
514 0 0 0 0 0 0 0 0 0 0 0 0 0 0 0 0 0 0 0 0 0 0 0 0 0 0 0 0 0 0 514 
514 0 0 0 514 514 514 0 0 0 0 0 514 0 0 0 0 0 0 514 0 0 0 0 0 514 514 514 0 0 0 514 
514 0 0 0 514 514 514 0 0 0 0 0 0 514 0 0 0 0 514 0 0 0 0 0 0 514 514 514 0 0 0 514 
514 0 0 0 514 514 514 0 0 0 0 0 0 0 514 0 0 514 0 0 0 0 0 0 0 514 514 514 0 0 0 514 
514 0 0 0 0 0 0 514 514 514 0 0 0 0 0 514 514 0 0 0 0 0 514 514 514 0 0 0 0 0 0 514 
514 0 0 0 0 0 0 514 514 514 0 0 0 0 0 0 0 0 0 0 0 0 514 514 514 0 0 0 0 0 0 514 
514 0 0 0 0 0 0 514 514 514 0 0 0 0 0 0 0 0 0 0 0 0 514 514 514 0 0 0 0 0 0 514 
514 0 0 0 0 0 0 0 0 0 514 514 514 0 0 0 0 0 0 514 514 514 0 0 0 0 0 0 0 0 0 514 
514 0 0 0 0 0 0 0 0 0 514 514 514 0 0 0 0 0 0 514 514 514 0 0 0 0 0 0 0 0 0 514 
514 0 0 0 2 74 37 0 0 0 514 514 514 0 0 0 0 0 0 514 514 514 0 0 0 2 38 73 0 0 0 514 
514 0 0 0 2 1 2 0 0 0 0 0 0 0 514 514 514 514 0 0 0 0 0 0 0 38 73 2 40 0 0 514 
514 0 0 0 38 74 2 0 0 0 0 0 0 0 0 0 0 0 0 0 0 0 0 0 0 2 37 37 0 0 0 514 
514 0 0 0 0 0 0 0 0 0 0 0 0 0 0 0 0 0 0 0 0 0 0 0 0 0 0 0 0 0 0 514 
514 0 0 0 0 0 0 0 0 0 0 0 0 0 0 0 0 0 0 0 0 0 0 0 0 0 0 0 0 0 0 514 
514 514 514 514 514 514 514 514 514 514 514 514 514 514 514 514 514 514 514 514 514 514 514 514 514 514 514 514 514 514 514 514 