285 286 286 286 286 286 286 286 286 286 286 286 286 286 286 286 286 286 286 286 286 286 286 286 286 286 286 286 286 286 286 287 
321 0 0 0 0 0 0 0 0 0 0 0 0 0 0 0 0 0 0 0 0 0 0 0 0 0 0 19 20 21 22 323 
321 0 0 0 0 0 0 0 0 0 0 0 0 0 0 0 0 0 0 0 0 0 0 0 0 0 0 55 56 57 58 323 
321 0 0 0 0 0 0 0 0 0 0 0 0 0 0 0 0 0 0 0 0 0 0 0 0 0 0 0 0 0 0 323 
321 0 0 0 0 442 442 0 0 0 0 0 0 0 0 0 0 0 0 0 0 0 0 0 0 0 0 0 0 0 0 323 
321 0 0 0 0 442 442 0 0 0 0 0 0 0 0 0 0 0 0 0 0 0 0 0 0 0 0 0 0 0 0 323 
321 0 0 0 442 442 0 0 0 0 0 0 0 0 278 278 278 120 0 0 0 0 0 0 208 209 0 0 0 0 0 323 
321 0 0 0 0 442 0 0 0 0 0 0 0 0 164 163 163 193 0 0 0 0 0 0 244 245 0 0 0 0 0 323 
321 0 0 0 0 0 0 0 0 0 0 0 0 0 163 163 163 193 0 0 0 0 208 209 0 0 0 0 0 0 0 323 
321 0 0 0 0 0 0 0 0 0 0 0 0 240 163 203 204 193 0 0 0 0 244 245 0 0 0 0 0 0 0 323 
321 0 0 0 0 0 0 0 0 0 0 0 0 163 163 239 240 193 0 0 0 0 0 0 0 0 0 0 0 0 0 323 
321 0 0 0 0 0 0 0 0 0 0 0 13 156 156 156 156 84 0 0 0 0 0 0 0 0 0 0 0 0 0 323 
321 0 0 0 0 0 0 0 0 0 0 0 0 0 0 0 0 0 0 0 0 0 0 0 0 0 0 0 0 0 0 323 
321 0 0 0 0 0 0 0 0 0 0 0 0 0 0 0 0 0 0 0 0 0 0 0 0 0 0 442 0 0 0 323 
321 0 0 0 0 0 0 0 0 0 0 0 0 0 0 0 0 0 0 0 0 0 0 0 0 442 442 442 0 0 0 323 
321 208 209 208 209 0 0 0 0 0 0 0 0 0 0 0 0 0 0 0 0 0 0 0 0 0 0 0 0 0 0 323 
321 244 245 244 245 0 0 0 0 0 0 0 0 0 0 0 0 0 0 0 0 0 0 0 0 0 0 0 0 0 0 323 
357 358 358 358 358 358 358 358 358 358 358 358 358 358 358 358 358 358 358 358 358 358 358 358 358 358 358 358 358 358 358 359 
