442 442 442 442 442 442 442 442 442 442 442 442 442 442 442 442 442 442 442 442 442 442 442 442 442 442 442 442 442 442 442 442 
442 0 0 0 0 0 0 0 0 0 0 0 0 0 0 0 0 0 0 0 0 0 0 0 0 0 0 0 0 0 0 442 
442 0 0 0 0 0 0 0 0 0 0 0 0 0 0 0 0 0 0 0 0 0 0 0 0 0 0 0 0 0 0 442 
442 0 0 0 0 0 0 442 0 0 0 0 0 0 0 0 0 0 0 0 0 0 0 0 442 0 0 0 0 0 0 442 
442 0 0 0 0 0 0 0 442 0 0 0 0 442 442 442 442 442 442 0 0 0 0 442 0 0 0 0 0 0 0 442 
442 0 0 0 442 0 0 0 0 442 0 0 0 0 442 442 442 442 0 0 0 0 442 0 0 0 0 442 0 0 0 442 
442 0 0 0 442 442 0 0 0 0 0 0 0 0 0 442 442 0 0 0 0 0 0 0 0 0 442 442 0 0 0 442 
442 0 0 0 442 442 442 0 0 0 0 0 0 0 0 0 0 0 0 0 0 0 0 0 0 442 442 442 0 0 0 442 
442 0 0 0 442 442 442 442 0 0 0 0 0 0 0 0 0 0 0 0 0 0 0 0 442 442 442 442 0 0 0 442 
442 0 0 0 442 442 442 442 0 0 0 0 0 0 0 0 0 0 0 0 0 0 0 0 442 442 442 442 0 0 0 442 
442 0 0 0 442 442 442 0 0 0 0 0 0 0 0 0 0 0 0 0 0 0 0 0 0 442 442 442 0 0 0 442 
442 0 0 0 442 442 0 0 0 0 442 0 0 0 0 442 442 0 0 0 0 442 0 0 0 0 442 442 0 0 0 442 
442 0 0 0 442 0 0 0 0 442 0 0 0 0 442 442 442 442 0 0 0 0 442 0 0 0 0 442 0 0 0 442 
442 0 0 0 0 0 0 0 442 0 0 0 0 442 442 442 442 442 442 0 0 0 0 442 0 0 0 0 0 0 0 442 
442 0 0 0 0 0 0 0 0 0 0 0 0 0 0 0 0 0 0 0 0 0 0 0 0 0 0 0 0 0 0 442 
442 0 0 0 0 0 0 0 0 0 0 0 0 0 0 0 0 0 0 0 0 0 0 0 0 0 0 0 0 0 0 442 
442 0 0 0 0 0 0 0 0 0 0 0 0 0 0 0 0 0 0 0 0 0 0 0 0 0 0 0 0 0 0 442 
442 442 442 442 442 442 442 442 442 442 442 442 442 442 442 442 442 442 442 442 442 442 442 442 442 442 442 442 442 442 442 442 