40 40 40 40 40 40 40 40 40 40 40 40 40 40 40 40 40 40 40 40 40 40 40 40 40 40 40 40 40 40 40 40 
40 40 40 40 40 40 40 40 40 40 40 40 40 40 40 40 40 40 40 40 40 40 40 40 40 40 40 40 40 40 40 40 
40 40 40 40 40 40 73 40 40 40 40 40 40 40 40 40 40 40 40 40 73 38 73 40 40 40 40 40 40 40 40 40 
40 40 40 40 40 40 40 40 40 40 40 40 40 40 40 40 40 40 40 40 40 255 256 256 257 40 40 40 40 40 40 40 
40 40 73 40 40 40 40 40 40 40 40 40 40 40 40 40 40 40 40 40 40 291 40 40 293 40 40 40 40 40 73 40 
40 40 40 40 40 40 1 40 40 40 40 40 40 40 40 40 40 40 40 40 40 291 40 40 293 40 40 40 40 40 40 40 
40 40 40 40 40 1 74 40 40 40 40 40 40 40 2 2 2 2 40 40 40 327 328 328 329 40 40 73 40 40 40 40 
40 40 40 40 40 40 40 40 40 40 40 40 40 40 2 40 40 40 40 40 40 38 73 38 40 40 40 73 40 40 40 40 
40 40 73 40 40 40 40 40 40 40 40 40 40 40 2 40 40 40 40 40 40 40 40 40 40 40 40 40 40 40 40 40 
40 40 40 40 40 40 40 40 40 40 73 40 40 40 2 40 2 2 2 40 40 40 40 40 40 40 40 40 40 73 40 40 
40 40 40 40 40 40 40 40 40 40 40 40 40 40 2 40 40 2 40 40 40 40 40 40 40 40 40 40 40 40 40 40 
40 40 40 40 40 40 40 40 40 40 40 40 40 40 2 2 2 2 40 40 40 40 40 40 40 40 40 40 40 40 40 40 
40 73 73 40 40 40 40 38 38 40 40 40 40 40 40 40 40 40 40 40 73 40 40 40 40 40 40 40 40 40 40 40 
40 40 40 40 40 40 40 40 40 40 40 40 40 40 40 40 40 40 40 40 40 40 40 40 40 40 40 40 40 40 40 40 
40 40 40 40 40 40 40 40 40 40 40 40 40 73 40 40 40 40 40 40 40 40 40 40 40 40 40 40 40 40 40 40 
40 40 40 40 40 40 40 40 73 40 40 40 40 40 40 40 38 40 40 40 40 40 40 40 40 40 40 40 40 40 40 40 
40 40 40 73 40 40 40 40 40 40 40 40 40 40 40 40 73 38 40 40 40 40 40 37 38 37 38 37 38 37 38 40 
40 40 40 40 40 40 40 40 40 40 40 40 40 40 40 40 40 40 40 40 40 40 40 40 40 40 40 40 40 40 40 40 
