421 421 421 421 421 421 421 163 163 163 163 163 163 163 163 421 421 163 163 163 163 163 163 163 163 421 421 421 421 421 421 421 
421 421 421 421 421 421 421 421 421 421 421 421 421 421 421 421 421 421 421 421 421 421 421 421 421 421 421 421 421 421 421 421 
421 421 421 421 421 421 421 421 421 421 421 421 421 421 421 163 163 421 421 421 421 421 421 421 421 421 421 421 421 421 421 421 
421 421 421 421 421 163 163 421 421 421 421 421 421 421 421 163 163 421 421 421 421 421 421 421 421 163 163 421 421 421 421 421 
421 421 421 421 421 163 163 421 421 421 421 421 421 421 421 163 163 421 421 421 421 421 421 421 421 163 163 421 421 421 421 421 
421 421 421 421 421 163 163 421 421 421 421 421 421 421 421 163 163 421 421 421 421 421 421 421 421 163 163 421 421 421 421 421 
421 421 421 421 421 163 163 421 421 421 421 421 421 421 421 163 163 421 421 421 421 421 421 421 421 163 163 421 421 421 421 421 
421 421 421 421 421 421 421 421 421 421 421 421 421 421 421 163 163 421 421 421 421 421 421 421 421 421 421 421 421 421 421 421 
421 421 421 421 421 421 421 421 421 421 421 421 421 421 421 421 421 421 421 421 421 421 421 421 421 421 421 421 421 421 421 421 
421 421 421 421 421 421 421 421 421 421 421 421 421 421 421 421 421 421 421 421 421 421 421 421 421 421 421 421 421 421 421 421 
421 421 421 421 421 421 421 421 421 421 421 421 421 421 421 163 163 421 421 421 421 421 421 421 421 421 421 421 421 421 421 421 
421 421 421 421 421 163 163 421 421 421 421 421 421 421 421 163 163 421 421 421 421 421 421 421 421 163 163 421 421 421 421 421 
421 421 421 421 421 163 163 421 421 421 421 421 421 421 421 163 163 421 421 421 421 421 421 421 421 163 163 421 421 421 421 421 
421 421 421 421 421 163 163 421 421 421 421 421 421 421 421 163 163 421 421 421 421 421 421 421 421 163 163 421 421 421 421 421 
421 421 421 421 421 163 163 421 421 421 421 421 421 421 421 163 163 421 421 421 421 421 421 421 421 163 163 421 421 421 421 421 
421 421 421 421 421 421 421 421 421 421 421 421 421 421 421 163 163 421 421 421 421 421 421 421 421 421 421 421 421 421 421 421 
421 421 421 421 421 421 421 421 421 421 421 421 421 421 421 421 421 421 421 421 421 421 421 421 421 421 421 421 421 421 421 421 
421 421 421 421 421 421 421 163 163 163 163 163 163 163 163 421 421 163 163 163 163 163 163 163 163 421 421 421 421 421 421 421