40 40 40 40 40 40 40 40 40 40 40 40 40 40 40 40 40 40 40 40 40 40 40 40 40 40 40 40 40 40 40 40 
255 40 40 40 257 40 40 40 73 40 40 40 40 40 40 40 40 40 40 40 40 40 40 40 40 40 40 40 40 40 40 40 
327 254 40 40 293 73 40 40 40 40 40 40 73 40 40 40 40 73 40 40 40 40 40 2 40 40 40 40 40 40 40 40 
40 291 40 40 293 73 73 40 40 40 2 40 40 40 40 40 40 40 40 73 40 40 40 2 40 40 73 40 40 40 40 40 
40 291 40 40 40 40 40 257 40 40 40 40 40 40 40 40 40 40 40 40 40 40 40 40 40 40 40 40 40 40 40 40 
40 330 328 328 328 328 254 293 40 40 40 40 40 40 40 40 1 40 1 40 40 40 40 40 40 40 40 40 40 40 40 40 
40 73 40 73 73 73 327 329 40 40 40 40 40 40 40 40 74 74 1 40 73 40 73 40 74 1 40 40 73 40 40 40 
40 40 40 40 40 40 40 40 40 2 40 40 40 40 40 40 1 40 1 40 74 73 74 40 1 74 40 40 40 40 40 40 
40 40 40 2 40 40 40 40 40 40 40 40 40 2 40 40 40 40 40 40 40 40 40 40 40 40 40 40 40 73 40 40 
40 40 40 40 40 40 40 40 40 40 2 40 40 40 40 40 40 40 40 40 40 40 40 40 40 40 40 40 40 40 40 40 
40 40 40 40 40 40 40 40 40 40 40 40 40 40 40 40 40 40 2 40 40 40 40 40 40 40 40 40 40 40 40 40 
40 40 40 40 40 40 40 40 40 40 40 40 40 40 40 2 40 40 40 40 40 40 40 40 40 40 40 40 40 73 40 40 
40 40 2 40 40 2 40 40 40 40 40 40 74 40 40 40 40 40 40 40 40 40 40 40 40 40 40 40 40 40 40 40 
40 40 40 40 40 40 40 40 40 40 40 40 40 40 40 40 40 40 40 40 40 40 40 40 40 2 40 40 40 40 40 40 
40 40 40 40 40 2 40 40 40 40 40 40 40 40 40 73 40 40 40 40 40 40 40 40 40 40 40 40 40 40 40 40 
40 40 40 40 40 40 40 40 40 40 2 40 40 40 40 40 40 40 40 2 40 40 40 40 40 40 40 40 40 40 40 40 
40 40 40 40 40 40 40 40 40 40 40 40 40 40 40 40 40 40 40 40 40 40 40 40 40 40 40 40 40 40 40 40 
40 40 40 40 40 40 40 40 40 40 40 40 40 40 40 40 40 40 40 40 40 40 40 40 40 40 40 40 40 40 40 40 
